----------
--Cc------
--cc------
--A-------
----------
----------
----------
----------
----------
--------A-