A--Ll--MAMA--Cc-AA--LlM-Ll-Ll-AA--A--A------------
A----LlmMm---cc--ALl--m---MCc--AA----M-Ll-MMCcCc-A
--Cc-A-Am---AM---A-ACc-AAAmccM-------mCc--mmcccc-M
-Acc-ACc-Ll--m--ALlAcc-AM--AMmLlLl--M-cc-MM-LlACcm
----MMccM-A--Ll--------Am-Ccm-Ll--CcmM---mmLl-Acc-
--MMmmLlmM-LlCc-A--Ll-A-LlccLlCcM-cc-m-----Cc-A-AM
--mm-----m-LlccLlM---M---LlLl-ccm--ALl-AMLlccLl--m
-Ll----A--A-Ll---m--AmCc-Ll---LlMMA----Am-A-AM-Cc-
-CcAM---LlM------M----ccAMLl----mm---AM-----Am-ccM
-cc-mA--M-mMA----m---M-CcmLlA---Ll--MMm--MLlA--A-m
-A--MM-Mm--mA-Ll---Llm-cc--M--AM--Ccmm---mCcCc----
ALl-mm-m-----M-LlLlLl-Ll---m---m-AccM-----cccc----
-----------A-m-Ll-LlLl--Ll---A---M--mAMA-Cc-M---Ll
--A--A----LlM----LlA-M-CcLl--Ll-AmA--Am-MccAm---Ll
-M--M-MACcCcmLl--CcCcmMccAMA-MA---Ll----m-ALlACcLl
-m--mAmAcccc--MA-cccc-m---mA-mACcM--Ll-----ALlcc--
M-AA----Ll--AAm-----MALlLlAM-Llccm-LlA---LlM-Ll--M
mLl-ALl--A---M---A--m-----Am-M------MM--A--m--A--m
-----M--LlLlAm-----CcM---Cc-Mm------mm-Ll-A-Ll--A-
---M-m-MA----------ccmAM-cc-mA-MCcCc------------Ll
AMAm---m-Cc-----Cc-----m--LlA--mcccc-------------A
-mLlA---Acc--Ll-cc-LlAMMM-LlM-M-------AMCc-Cc-LlA-
M--Cc-Cc-A--A--A-----Ammm---m-m-M--LlCcmcc-ccM----
mM-cc-cc---MCc-ACc-Ll--M---Ll-MAm--LlccLlLlA-m----
-m-A--A-A--mcc--ccM----m------mA--MCc--CcCcCc-----
--Cc-Ll------Cc---m----A---A------mcc--ccccccLlALl
--cc-AMM--Ll-ccLl-Ll-M--AAA-A-Cc------A----ALl--A-
M----Amm----A---CcCc-mA-ACcMCccc--MMA----Cc----ACc
m-MM-AM-A--LlAM-cccc--CcAccmcc----mm--MMAccLl-Llcc
--mm-Mm-Cc----m---Cc--ccA--Cc-Cc---Ll-mm--LlCc----
-----mA-cc---AA---cc--A--A-cc-ccMLl-LlM--ALlcc----
--A-ACc--MM----M-------MAM-Cc--Am--M--mLlM--Ll----
--M--ccLlmm-A-MmA---A--m-m-cc-LlACcmMLl--mCcAM-AAA
--mAA---------mA-Cc--Ll----LlLl--cc-m-----cc-m---M
----Ll----MMLl-A-cc-Ll---AAA-Ll----AAAA---Ll--Cc-m
----Cc----mm-Cc------AA--M------MAM--A-CcAAAA-cc--
LlM-cc-A-----cc-ACcLl----mM--Cc-m-m-A--ccA----M-Ll
--mM-------LlA--MccLl-----mLlccM----Ll-AA--LlMm---
---m-M-M-------Mm-MLl-M-------Am--M-AA-MMM-LlmAM--
--Ll-m-m-LlLl--m--mM--mLl----MA--AmLl--mmm--AA-m--
-----------AAA-----m---A-Cc--m-Ll-------Ll-Cc-A---
-A-Ll-Ll----LlA--ACc-Cc--ccA--Cc-Ll--------ccM-MA-
-A--A-----M--CcM--cc-cc--Ll---ccCc--A--Cc-LlAmAm-A
M------ALlmCcccmLl----Ll-Ll---A-ccLl---cc--M------
m---A--AMAMccAM-LlMLl--MM-MLlCc-M----LlCc-MmA--M-A
ALl-AALlm-m-A-mMCcmCc--mmMm--ccAmCc----ccMm-ALlmMA
------M--Ll-Ll-mcc-cc--AMmCc-----cc--A---m------m-
---Cc-m----A------------m-cc-----Cc-Cc-M----Ll----
---ccLl----Cc--M----Cc-M--Cc--Ll-ccAccAm-M--CcCc--
-Ll-LlA-A--cc-Am--Llcc-mLlcc---A--Ll--Ll-m-AccccLl
